MICHAEL	PERSON
F.	PERSON
NEIDORFF	PERSON
Chairman	TITLE
President	TITLE
CEO	TITLE
ORLANDO	PERSON
AYALA	PERSON
Vice	TITLE
President	TITLE
Chairman	TITLE
Chief	TITLE
Advisor	TITLE
ROBERT	PERSON
K.	PERSON
DITMORE	PERSON
President	TITLE
FREDERICK	PERSON
H.	PERSON
EPPINGER	PERSON
President	TITLE
CEO	TITLE
VICKI	PERSON
B.	PERSON
ESCARRA	PERSON
CEO	TITLE
former	TITLE
Director	TITLE
of	TITLE
Health	TITLE
Net	TITLE
RICHARD	PERSON
A.	PERSON
GEPHARDT	PERSON
Chief	TITLE
Executive	TITLE
Officer	TITLE
JOHN	PERSON
R.	PERSON
ROBERTS	PERSON
Retired	TITLE
Regional	TITLE
Managing	TITLE
Partner	TITLE
DAVID	PERSON
L.	PERSON
STEWARD	PERSON
Chairman	TITLE
of	TITLE
the	TITLE
Board	TITLE
TOMMY	PERSON
G.	PERSON
THOMPSON	PERSON
Former	TITLE
Health	TITLE
&	TITLE
Human	TITLE
Services	TITLE
Secretary	TITLE
Former	TITLE
Governor	TITLE
